國鳥




藍孔雀 印度的國鳥






綠雉 日本的國鳥






戴氏鷴 泰國的國鳥






藍蓑羽鶴 南非的國鳥






古巴咬鵑 古巴的國鳥






棕腹鶇 巴西的國鳥






安第斯動冠傘鳥 秘鲁的國鳥




國家象徵




事物


國號
國旗
國徽
國歌

國旗歌


國慶日
國家格言
國家代表色
國籍標誌
國家代碼
國家航空公司
國技
國樂
國璽
國石（日语：国石）
國菜（英语：National dish）








人物或拟人形象


國家元首
国父
国家化身








非人生物


國獸（英语：List of national animals）

國鳥


國花
國樹









查
论
编





國鳥是國家的一种象徵。以下的國鳥列表大多數為官方認定。



目录


1 亞洲
2 歐洲
3 非洲
4 美洲
5 大洋洲



亞洲[编辑]

孟加拉 - 鵲鴝（Copsychus saularis）[1]
不丹 - 渡鴉（Corvus corax）[2]
中華民國 - 台灣藍鵲（Urocissa caerulea）民间行为，非官方认可。
印度 - 雄性藍孔雀（Pavo cristatus）
印度尼西亞 - 爪哇鷹鵰（Spizaetus bartelsi）
伊朗 - 夜鶯（Luscinia megarhynchos）和藍孔雀，兩者都不是官方公佈的國鳥。
伊拉克 - 石雞（Alectoris chukar）
以色列 - 戴勝（Upupa epops major），希伯來語: Doochifat（דוכיפת）。
日本 - 綠雉（Phasianus versicolor），日語: kiji（キジ）。
約旦 - 沙色朱雀（Carpodacus synoicus）
哈萨克斯坦 - 金雕（Aquila chrysaetos）
韓國 - 朝鮮喜鵲（Pica sericea）
馬來西亞 - 馬來犀鳥（Buceros rhinoceros）
緬甸 - 灰孔雀雉（Polyplectron bicalcaratum）
尼泊爾 - 棕尾虹雉（Lophophorus impejanus）
巴林 - 白頰鵯（Pycnonotus leucogenys）
巴基斯坦 - 石雞（Alectoris chukar）為國鳥，游隼（Falco peregrinus）為國家軍隊鳥。
菲律賓 - 食猿鵰（Pithecophaga jefferyi）
新加坡 - 黃腰太陽鳥（Aethopyga siparaja）[3]
斯里蘭卡 - 錫蘭野雞（Gallus lafayetti）
泰國 - 戴氏鷴（Lophura diardi）
土耳其 - 白眉歌鶇（Turdus iliacus）
阿拉伯聯合酋长國 - 游隼（Falco peregrinus）

歐洲[编辑]

奧地利 - 金雕（Aquila chrysaetos）
白俄羅斯 - 黑鸛（Ciconia nigra）
比利時 - 紅隼（Falco tinninculus）
丹麥 - 疣鼻天鵝（Cygnus olor）
愛沙尼亞 - 家燕（Hirundo rustica）[4]
芬蘭 - 大天鵝（Cygnus cygnus）
法國 - 高盧雄雞（Gallus gallus）
格鲁吉亚 - 雉雞（Phasianus colchicus）
德國 - 白鸛（Ciconia ciconia）
匈牙利 - 大鴇（Otis tarda），非正式的馬札爾民族象徵鳥為神鷹(Turul)或獵隼。
冰島 - 海东青（Falco rusticolus）
愛爾蘭 - 未定，鷦鷯（Troglodytes troglodytes）和歐亞鴝（Erithacus rubecula）為候選鳥。
拉脫維亞 - 白鶺鴒（Motacilla alba）
立陶宛 - 白鸛（Ciconia ciconia）
盧森堡 - 戴菊（Regulus regulus）
馬爾他 - 藍磯鶇（Monticola solitarius）
挪威 - 白喉河烏（Cinclus cinclus）
波蘭 - 白尾海雕（Haliaeetus albicilla）
羅馬尼亞 - 白鵜鶘（Pelecanus onocrotalus），僅為推薦國鳥。
瑞典 - 黑鶇（Turdus merula）
英國 - 歐亞鴝（Erithacus rubecula）

非洲[编辑]

安哥拉 - 游隼（Falco peregrinus）[5]
博茨瓦纳 - 紫胸佛法僧（Coracias caudata）或牛背鷺（Bubulcus ibis[6]
冈比亚 - 未定，但有提議為藍腹佛法僧（Coracias cyanogaster）及距翅雁（plectropterus gambensis）[7]
肯尼亚 - 原雞（Gallus gallus）或黑冕鶴（Balearica pavonina），非官方。
莱索托 - 禿䴉（Geronticus calvus）
利比里亚 - 非洲羽須鵯（Pycnonotus barbatus）
马拉维 - 斑尾咬鹃（Apaloderma vittatum）[8]
毛里求斯 - 渡渡鳥（Raphus cucullatus）
納米比亞 - 红胸黑鵙（Laniarius atrococcineus）[9]
尼日利亚 - 黑冕鶴（Balearica pavonina）
卢旺达 - 灰冠鶴（Balearica regulorum），非官方。
圣多美和普林西比 - 非洲灰鸚鵡（Psittacus erithacus）及黑鳶（Milvus migrans）
塞舌尔 - 斯瑟馬島小鸚鵡（Coracopsis nigra barklyi）
南非 - 藍蓑羽鶴（Anthropoides paradisea）[10]
蘇丹 - 蛇鷲（Sagittarius serpentarius）
南苏丹 - 吼海雕（Haliaeetus vocifer）
斯威士兰 - 紫冠蕉鵑（Tauraco porphyreolophus）[11]
坦桑尼亞 - 灰冠鶴（Balearica regulorum），非官方。
烏干達 - 灰冠鶴（Balearica regulorum）
赞比亚 - 吼海雕（Haliaeetus vocifer）[12]
津巴布韦 - 吼海雕（Haliaeetus vocifer）[13]

美洲[编辑]

安提瓜和巴布达 - 麗色軍艦鳥（Fregata magnificens）
阿根廷 - 棕灶鳥（Furnarius rufus）[14]
巴哈馬 - 加勒比海紅鸛（Phoenicopterus ruber）[15]
伯利兹 - 彩虹巨嘴鳥（Ramphastos sulfuratus）[16][失效連結]
玻利維亞 - 安地斯神鷹（Vultur gryphus）
巴西 - 棕腹鶇（Turdus rufiventris）[17]
智利 - 安第斯神鷹（Vultur gryphus）
哥倫比亞 - 安第斯神鷹（Vultur gryphus）
哥斯大黎加 - 王鷲（Sarcoramphus papa）
古巴 - 古巴咬鵑（Priotelus temnurus）
多米尼克 - 帝王亞馬遜鸚鵡（Amazona imperialis）
多米尼加 - 棕櫚䳭（Dulus dominicus）
厄瓜多 - 安第斯神鷹（Vultur gryphus）
薩爾瓦多 - 綠眉翠鴗（Eumomota superciliosa）[18]
格兰纳达 - 格林納達棕翅鳩（Leptotila wellsi）
瓜地馬拉 - 鳳尾綠咬鵑（Pharomachrus mocinno）
蓋亞那 - 麝雉（Opisthocomus hoazin）
海地 - 伊斯帕尼奥拉咬鵑（Temnotrogon roseigaster）
洪都拉斯 - 黃頸亞馬遜鸚鵡（Amazona auropalliata）
牙買加 - 紅嘴長尾蜂鳥（Trochilus polytmus）
墨西哥 - 金雕（Aquila chrysaetos），非官方。
尼加拉瓜 - 綠眉翠鴗（Eumomota superciliosa）
巴拿馬 - 角雕（Harpia harpyja） [19]
巴拉圭 - 裸喉鐘雀（Procnias nudicollis）
秘魯 - 安第斯冠傘鳥（Rupicola peruviana）
聖克里斯多福及尼維斯 - 褐鵜鶘（Pelecanus occidentalis）
聖露西亞 - 聖盧西亞亞馬遜鸚鵡（Amazona versicolor）
圣文森特和格林纳丁斯 - 聖文森亞馬遜鸚鵡（Amazona guildingii）
特立尼达和多巴哥

特立尼达 - 美洲紅䴉（Eudocimus ruber）
多巴哥 - 棕臀稚冠雉（Ortalis ruficauda）


美國 - 白頭海鵰（Haliaeetus leucocephalus） [20]
烏拉圭 - 鳳頭距翅麥雞（Vanellus chilensis）
委內瑞拉 - 擬黃鸝（Icterus icterus） [21]

大洋洲[编辑]

澳大利亞 - 鴯鶓（Dromaius novaehollandiae），非官方[22]，出現在澳大利亞國徽上，但也有一說是琴鳥
斐濟 - 綠領吸蜜鸚鵡（Phigys solitarius）
新西蘭 - 奇異鳥（Apteryx australis）
帕劳 - 帕島果鳩（Ptilinopus pelewensis）
巴布亞新幾內亞 - 紅羽天堂鳥（Paradisaea raggiana）[23]
薩摩亞 - 齒鳩（Didunculus strigirostris）
汤加 - 太平洋皇鳩（Ducula pacifica）
安圭拉 - 鳴哀鴿（Zenaida aurita），但當地人常誤稱為歐斑鳩。[24]





分类：國鳥鸟类分布列表脊椎動物亞門隐藏分类：带有失效链接的条目条目有永久失效的外部链接